ni : you
nihao : hi; hello
henhao : very well
wo henhao : im very well
ganbei : cheers
wo budong : i dont understand
dong : to understand
wodong : i understand
wo : i
hen : very
xiexie : thank you
keqi : courteous； polite
bu keqi : you are welcome
nage : that one
zhege : this one
san: three; 3
er : two; 2
yi : one; 1
haode : okay
mei guanxi : it doesnt matter
guanxi : connection
zaijian : goodbye
duibuqi : im sorry
budui : not correct
dui : correct; pair; towards
women : we
women zou ba : lets go
mei : not; not have
yige : one of something
sange : three of something
nimen : you (plural)
ma : question marker
nihao ma : how are you
shenme : what
jiao : to call; to shout
mingzi : name
kaixin : happy
wo jiao : my name is
shangxin : sad
shengqi : angry
cuole : wrong
meicuo : not wrong; thats right
lei : tired
shengbing le : got sick
è : hungry
kě : thirsty
nǐ kāixīn ma : are you happy
wǒ hěn kāixīn : im happy
wǒ bù kāixīn : im not happy
nǐ jiào shénme míngzì : whats your name
wǒ cuòle ma : am i wrong
nǐ méicuò : you are not wrong
zěnme : how
zěnme le : whats up; what happened
wǒ hěn è : im very hungry
he : to drink
nǐ kě ma : are you thirsty
wǒ bù kě : im not thirsty
mǎshàng : right now
chī : to eat
shíwù : food
miànbāo : bread
miàntiáo : noodles
mǐfàn : cooked rice
bāozi : steamed stuffed bun
jiǎozi : dumpling
zhōu : congee
tāng : soup
tǔdòu : potato
cài : dish; vegetable
shūcài : vegetable
shuǐ : water
女 : woman; female 
人 : person
子 : child; noun suffix
小 : small
干 : dry; to do
不 : no; not
好 : well; good
二 : two
面 : flour; noodles; face
木 : wood
杯 : cup
再 : again
三 : three
见 : to see; to look
个 : a measure word
一 : one; a
马 : horse
日 : sun; day
白 : white
勹 : wrap
勺 : spoon
的 : belonging to
心 : heart
了 : completed action marker